db.brands.insertOne({id:120150,name:"Brera Orologi",alias:["Brera Milano"],url:"https://breramilano.com/en/",country:"ITALY",description:"",class:["Luxury"],location:{official:{en:"https://breramilano.com/en/",it:"https://breramilano.com/it/"}}})
db.brands.insertOne({id:120160,name:"Brooklyn Watch Co.",url:"",country:"",description:"",class:["Luxury"],location:{}})
db.brands.insertOne({id:120170,name:"Bulova",url:"",country:"",description:"",class:["Luxury"],location:{}})
db.brands.insertOne({id:120180,name:"Burberry",url:"",country:"",description:"",class:["Luxury"],location:{}})
db.brands.insertOne({id:120190,name:"Burgi",url:"",country:"",description:"",class:["Luxury"],location:{}})
db.brands.insertOne({id:120200,name:"Berd Vay'e",url:"",country:"",description:"",class:["Luxury"],location:{}})
db.brands.insertOne({id:120210,name:"Bovet",url:"",country:"",description:"",class:["Luxury"],location:{}})
db.brands.insertOne({id:,name:"",url:"",country:"",description:"",class:["Luxury"],location:{}})
db.brands.insertOne({id:,name:"",url:"",country:"",description:"",class:["Luxury"],location:{}})



Cabochon | Calibre | Calvin Klein | Casio | Certina | Charriol | Chaumet | Chronoswiss | Claude Bernard | Cluse | Crayo | Credor | Cuervo Y Sobrinos
Daniel Wellington | De Grisogono | Deep Blue | Dewitt | Diesel | Dietrich | Dior | Dkny | DOXA
Earth | Edox | Elevon | Elini Barokas | Ellen Tracy | Emporio Armani | Empress | Equipe | Ernest Borel
Ferrari | Ferre Milano | Fortis | Fossil | Franc Vila | Furla
Gc By Guess | Geoffrey Beene |  Gevril | Giulio Romano | Glycine | Grand Seiko | Guess | Gv2 By Gevril
Haurex Italy | Heritor
Ice-Watch | Invicta | ID Genève
Jbw | Jivago | Johan Eric | Jorg Hysek | Joshua And Sons | Junghans | Just Cavalli
Kate Spade | Kenneth Cole | Kross Studio
Lacoste |  Lancaster | Lego | Locman | Louis Erard | Lucien Piccard | Luminox | L’epee 1839
Marc Jacobs | Maserati | Mathey-Tissot | Michael Kors | Michele | Mido | Milus | Mondaine | Morphic | Mulco | Massena LAB
Nautica | Nixon | Nivada Grenchen
Oceanaut | Olivia Burton | Oniss | Orient | QLOCKTWO
Paul Picot | Philip Stein | Picasso And Co | Police
Rebel | Reign | Revue Thommen | Roberto Cavalli | Rudiger | Reservoir | Ressence
Seiko | Sinn | S Coifman |  Sekonda | Sevenfriday | Shield | Shinola | Simplify | Skagen | Sophie And Freda | Stuhrling Original | Suunto
Swarovski | Swatch | Swiss Military | Speake-Marin
Tudor | TAG Heuer | Technomarine | Thomas Earnshaw | Timex | Tissot | Tommy Hilfiger | Tw Steel | The Watch Stand
Ulysse Nardin | U-Boat | Urwerk
Vacheron Constantin | Van Cleef & Arpels | Vulcain | Ventura | Versace | Versus By Versace | Victorinox
Waldhoff | William Wood Watches | WOLF
Zenith | Zeno




